aadtjegh	vastikään, vasta, juuri
aadtjen	vastikään
aagkele	pallea
aahka	mummo
aahketjeguaktah	hän ja isoäitinsä
aahkove	lapsenlapsi (isoäidille)
aahtjebe	heidän isänsä
aaj	myös
aajahtalledh	ajatella
aajhtsedh	huomata
aajja	isoisä
aajjetjeguaktah	hän ja isoisänsä
aajjove	lapsenlapsi (isoisälle)
aajkoehkadtjh	serkukset
aajkohke	serkku
aajmojne	jäljellä, tallella
aajmene	jäljellä, tallella
aajroe	airo
aaksjoe	kirves
aalkoe	alku
aalkove	alku
aalebovtse	teurasporo
aales	rauhallinen, pedoton
aaloe	(puun) mahla, (lihan, kalan) mehu
aalohke	kumisaapas
aaltoe	vaadin
aamhtse	asia, aihe
aamhte	asia, aihe
aamhtese	asia, aihe
aamhtsegïetedallije	virkailija
aanja	poron (etu)jalan jänne (josta punotaan suonilankaa)
aarh	varhainen
aareh	varhainen
aarehke	varhainen; varhain vasova poro
aarhskuvlelohkehtæjja	esikoulun opettaja
aarhtse	kotka
aate	tavara, esine
aatovmefaamoesijjie	ydinvoimala, atomivoimala
aatskadidh	pyrkiä, puuhata
aatsolen	ylle, yllä, yli
aavhtestidh	ammentaa, äyskäröidä
aavoe	ilo
aavone	iloissaan
aavrehke	onnekas
aavtjoe	(kirveen, veitsen) terä
abpe	koko(nainen)
abpelsijne	appelsiini
abpese	pusero, villapaita
aeblehts	laiska
aegkiedåvna	untuvatyyny
aegkiegaptjese	untuvapeite
aehtjaahka	isän äiti, mummo
aehtjaajja	isän isä, vaari
aehtjie	isä
aejkie	kerta; aika
aejlege	sunnuntai
aejlies	pyhä  
aejmie	äimä (kolmikulmainen neula nahan ompelemiseen)
aelhkie	helppo
aelkedh	alkaa
aellieh	älä
aelmies	maukas
ae nagkh	han, hän; siis
aerebi	ennen, ensin, aiemmin	
aerede	aamu, huomen
aeredsbeapmoe	aamiainen
aeriebistie	aikaisemmin, ennestään, edeltä
aerkies	arka, pelokas
aernie	tulisija
aerviedidh	arvata, arvella, olettaa
aevere	erityisemmin
aevlerge	kodan harjaorsi, keittoorsi
aevsie	poron otsaluu sarvineen
ahtjetje	vähäsen
ajve	vain
akte	yksi
aktine	yhdessä
almetje	ihminen
altese	hänen; heidän; nsa
alvas	kovin, kauhean
amhkedh	synkkä ja pilvinen sää
amma	toki; pas, päs
ammes	vieras, outo
annje	vielä
arhpedh	malttaa
arhpehtovvedh	kyllästyä, tulla kärsimättömäksi
aske	kuu, kuukausi
askedh	kuutamo, kuunloiste
assh dohkoe	hus pois (koiralle)
astedh	ehtiä
astoe	aika (johonkin)
asvedidh	pelätä, tuntea kauhua
asvedihks	pelottava, kauhea
baahkedidh	lämmittää
baahkes	lämmin
baahke	lämmin
baahketjaetsie	kuuma vesi
baahkoe	(tunturin, vuoren)rinne
baahtje	poika
baahtjetje	pikkupoika
baahtsedh	päästä (yli, läpi, irti)
baahtsege	eläimen sydän; puun käpy
baajedh	antaa, sallia
baajkoe	kova pakkanen
baajnedh	imeytyä 
baakoe	sana
baakohth	sanaton
baaktoe	kautta, ohitse
baalhka	palkka
baalka	polku
baalte	sivulla, vieressä; ohi
baarhkoe	puun kuori; parkki(liemi)
baarhkoegalte	kaarnapölkky (koivupölli, josta irrotetaan kaarnaa)
baarnetje	pikkupoika
badth	han, hän, toki
badtja	voide
bådtja	voide
badtjadidh	voidella
bådtjadidh	voidella
badtse	sulka
baejhtedh	ajaa, ohjata (poroja tiettyyn suuntaan)
baektjiedidh	särkeä, olla kipeä
baeledh	siivota, puhdistaa (lumesta tai vanhoista kotarisuista)
baenie	hammas
baeniesaehpie	hammasharja
baeniekreeme	hammastahna
baerehke	aurinkoinen rinne, auringonpuoli, auringonpaiste
baernie	poika
baetjkere	(hillan) raakile
baetsedh	jäädä
bahkasidh	katketa
bahte	takamus
bajsjeme	käytävä
balka	kenkäheinäpunos, jossa on useita sormauksia
baltehke	kummitus
balve	pilvi
bangseme	huuli
barhve	(poron) raato
barkedh	työskennellä
barkije	työntekijä
barkoe	työ
barkoes	työntäyteinen
barre	vain
beagkoes	tuulinen
bealese	puoleen, luo; lisäkkeeksi
bealesne	puolella, puolessa
bealloe	tiuku, kello
bealloeaaltoe	kellovaadin
beapmoe	ruoka
beapmoejurjiehtæjja	kokki, keittäjä
beapmoevoesse	eväspussi, ruokasäkki
bearjadahke	perjantai
bearjedsiehkede	perjantaiilta
bearkadidh	selvitä, selviytyä, pärjätä
bearkoe	liha
bearkoegaamsoe	lihapulla
bearkoejoptse	lihakeitto
bearkoekrovhte	lihapata
beavloes	lumeton
beelhte	vyö
beensine	bensiini 
beenghkedh	lyödä, hakata, koputtaa
beere	karhu	
beetnegh	raha(t)
beetnegadtje	vähän rahaa
bejsjeme	oviaukon molemmin puolin oleva tila kodassa
bajsjeme	oviaukon molemmin puolin oleva tila kodassa
bejsjememoerh	ovenpielipuut, permikkäpuut
belnie	mätäs, kumpare, kasa
berkiestidh	tupruta, savuta
bertedh	latoa, pinota
bestele	terävä
besteles	terävä
betnie	pohja
betniegierkie	pohjakivi
bïegke	tuuli
bïegketje	tuulenvire
biehkie	pala, kappale
bïejedh	panna
biejjegi	päivisin
biejjie	päivä
biejjiebaerehke	aurinkoinen rinne, auringonpuoli, auringonpaiste
biejjienbaerehke	aurinkoinen rinne, auringonpuoli, auringonpaiste
bïejkelidh	loukata, nyrjäyttää
bïejstenidh	turmeltua, mennä pilalle
bielie	puoli
bïeljelidh	mainita, ilmoittaa
bieljie	korva
bïenje	koira
bïerkenidh	selvitä, selviytyä, pärjätä
bïerne	karhu
biesie	pesä
biessie	tuohi
biestedh	päästää
biestielidh	menettää, päästää karkuun
bietsie	mänty, petäjä
bietskiedidh	leikata
bïevestohtedh	hikoilla, tulla hikiseksi
bïevestovvedh	hikoilla, tulla hikiseksi
bïevle	pälvi
bïevledh	pälviintyä, tulla lumettomaksi
bïevsterh	mieliala, tuuli
bigkedh	rakentaa
bihkedh	kerätä, poimia; nyhtää irti
bïhkedidh	neuvoa, ohjata
bijjede	ylhäältä
bijjelen	yli
bijjemes	ylin
bijjene	ylhäällä
bijjiebasse	ylemmäs
bijjierietjmie	verkon yläpaula	
bïjle	auto
bïjlebovre	autokauppa
bïjlevuejemelohkehtæjja	autokoulun opettaja
bïjre	ympäri
bijredh	silputa ja/tai paistaa lihaa
bïjredh	jyrsiä, järsiä
bïjre jarkan	ympäri(llä)
bïjvedh	tarjeta
bïjvele	lämmin (sää)
bïjvelåbboe	lämpimämpi
bïksedh	siepata, pyydystää
bïlledh	pelätä
bïllijidh	pelästyä
binhtedh	siivota, korjata jälkensä; korjata talteen
binte	kaulaliina
bïrhke	(pieni) porotokka
bïrhketje	pieni porotokka
bïrsje	(kalan) pyrstö (ja evät)
bissedh	paistaa
bïssedh	pestä
bïssedidh	peseytyä
bissemegietjie	paistotikku, varras
bissemesijjie	paistopaikka
bissemevuebnie	paistouuni
bist	taas, sitten, puolestaan
blomma	kukka(nen)
boehth	vastapäätä
boelhke	pätkä, pala, kappale, (ajan)jakso
boelhketje	(luku, näytös)kappale
boelte	lehtimetsä, koivua kasvava metsänrinne
boelnedh	kuihtua, kellastua
boelve	polvi
boelvedidh	polvistua
boelvhjöölki	polvillaan
boenge	povi
boengeskuvmie	naisen puvun rintalappu
boerehks	antelias
boetje	penis
boevedh	valvoa (ja pitää hauskaa)
bongke	rahapussi, kukkaro
bonhkehtalledh	töniä, työnnellä
bovre	kauppa	
bovtse	poro
bovtsebïenje	porokoira
bovvehtjidh	tappaa
brorke	pyy
buajtehke	lihava, rasvainen
buaranidh	parantua
buarastehtedh	tervehtiä, kätellä
buaredh	poutasää
buaregh	terve (käteltäessä)
buejtie	rasva
buektedh	tuoda
buektiehtidh	kyetä, saada aikaan
bueledh	palaa
buelielidh	palaa (nopeasti)
buerebe	parempi
buerie	hyvä
buerkiestidh	selittää, neuvoa
buertie	pöytä
bullere	pallero, pallo
burhvie	poronjäkälä
busse	bussi
buste	lusikka
buvrie	aitta, varasto
byjreske	ympäristö
byöpmedidh	syödä
byöpmedimmie	ruoka
byöpmetjh	vähän ruokaa
bægkah	(matka)tavarat
bæhta	pala, kappale
bæhtoe	astia, pönttö
bæjhpa	piippu
bæjhpoe	piippu
bæjjaldahke	yläpuoli, yläosa
bæjjesvåårti	ylöspäin, tunturiin, kevätmuuton suuntaan
bæjngoldsmåvhka	päällyshousut
bæjngoldsmåvhkah	päällyshousut
bæjngoldsvaarjoe	päällysvaate
bæjngolen	ulkopuolella, ulkopuolelle
bööredh	tarjota; kutsua
bööremes	paras
bööresovvedh	tulla kutsutuksi, saada kutsu
båadtsode	alasti, alaston
båanta	talonpoika, maanviljelijä
båarasåbpoe	vanhempi
båarasommes	vanhin
båassjoe	kodan takaosa, posio
båassjoeraejkie	kodan posioaukko
båatsoealmetje	poromies, poronhoitaja
båatsoeburrie	poromies
båatsoesaemie	porosaamelainen
båavjoeh	vaaleanharmaa (poro)
båeltielidh	polttaa
båeries	vanha
båetedh	tulla
båetije bearjadahken	ensi perjantaina
båetskie	kanta(pää)
bårras	hajallaan (oleva)
bårredh	syödä (eläin)
bårrestohtedh	tulla nälkäiseksi
båvne	mätäs, kumpare, harjanne
bååhkesjidh	leipoa
bååhperidh	ihmetellä, hämmästellä, päivitellä
bååktjehke	kipeä
bååstede	takaisin
bååstide	takaisin
daagkoe	täällä, tätä kautta
daajedidh	ymmärtää, käsittää
daajje	taikina
daajkoe	täällä(päin)
daajroes	tiettävästi, tietysti
daakteme	täysikasvuinen
daalhkesh	lääke, lääkkeet	
daamhtaj	usein, jatkuvasti
daamhtetje	usein, jatkuvasti
daanbiejjien	tänään
daanhtsodh	tanssia
daanhtsoestidh	tanssahtaa
daarhve	täplä; pilkka
daaroe	norjalainen, ruotsalainen; norjan, ruotsinkielinen
daaroestidh	puhua norjaa/ruotsia
daarpesjidh	tarvita
daase	tähän
daate	tämä
daatje	norjalainen, ruotsalainen
daatovre	tietokone
dabranadtedh	olla takertuneena kiinni
dabranidh	tarttua, jäädä kiinni
daebpene	täällä
daebrie	perna
daejredh	tietää
daelie	nyt
daelhkie	(ajo)keli; sää
daelvege	talvella
daelvie	talvi
daelvielaante	talvialue, talvilaidun(maa)
daemies	kesy
daenbiejjien	tänään
daenaereden	tänä aamuna
daennie	tässä; tänä
daerpies	tarpeellinen, tarpeen
daesnie	tässä
daestie	tästä
daevere	tavara
dagke	kos, kös
dagkeres	sellainen
dagkere	sellainen
dah	ne, he
dah guaktah	he kaksi
dahkoe	sinne
dahpe	tuppi
dahpedh	sulkea
dalhkedh	tulla (esiin), ilmestyä
dallah	heti, saman tien
dallahmasten	nopeasti, hetimmiten
dallatjinie	heti, saman tien
dallegh	heti, saman tien
dalvese	vuoren, tunturinhuippu
damtedh	tuntea; kokeilla; maistaa
damtehtidh	tunnustella, koettaa
dan	sen, siihen; niin
dan aereden	sinä aamuna
darhkh	sitten; kaan, kään
darks	sitten; kaan, kään
darhke	sitten; kaan, kään
darjodh	tehdä
darjomes	tekeminen
darjome	tekeminen
darvedh	tervata
dastegh	yhtäkkiä; siltä varalta että
datne	sinä
datne dihte	sinä(pä) se
deahpadidh	sattua, tapahtua
deajvoe	juurista punottu juustomuotti
deakehke	kotapuu, ruode
dealodh	kattaa pöytä
dealoe	pöytäliina; tarjoilualusta
Dearna	Tärnaby
deava	mäki, kukkula
deavabaahkoe	mäenrinne
deavetje	pieni kumpu
debpene	tuolla
debriehtidh	kiinnittää (neuloilla), harsia
deehkehtidh	pyyhkiä, silittää
deejehtidh	panna kenkäheinä kunnolla kenkään
deemedh	kesyttää
deere	uros(koira)
deereriepie	uroskettu
deerpegh	tarpeet, tarvikkeet, varusteet
dejkoe	tuolla (ympäriinsä)
dejpeli	entisaikaan
dej beeli	entisaikaan
dejpelatje	entisaikainen, muinainen
dejbaaletje	entisaikainen, muinainen
delhkiehtidh	ilmestyä paikalle (susi)
dellie	silloin, sitten
dellie maajetjh	vihdoin viimein
dennie	sinä, siinä
derhvie	turve
derhviegåetie	turvekota, kammi
desnie	siinä
destie	siitä
dibrehtidh	kiinnittää
diedtedh	painaa
die	niin
diekie	tänne
dïenesjidh	tienata, ansaita
dïeves	täysi
dïeve	täysi
dievhtedh	täyttää
dieviedidh	tavata, kohdata, osua
dievviedidh	tavata, kohdata, osua
dih	te (lyhyt muoto sanasta dijjieh)
dihte	se, hän
dijjieh	te
dïjmedh	pehmetä
dïjnehkh	sokeri
dijpedh	napata, tarttua; käydä onkeen
dïjpedh	napata, tarttua; käydä onkeen
dimperebuvrie	puuvaja
dïrrege	työkalu	
disse	sille, hänelle; sinne
dle	sitten (sanan dellie lyhyt muoto)
doekedh	myydä
doekije	myyjä
doekoe	vasten, kohden
doeka	vasten, kohden
doeltedh	kiehua
doeltejehtedh	kiehauttaa
doeltijahtjedh	kiehauttaa
doeltestidh	kiehahtaa
doeltijidh	alkaa kiehua
doengedh	paikata, korjata
doeredh	kokea (verkko)
doeredidh	kokea (verkkoja)
doerke	torko, kotarisu
doerkestidh	kattaa risuilla, (lattia)varvuilla
doestedh	uskaltaa
doete	se (sinua lähempänä oleva)
dohkh diekie	sinne tänne
dohkoe	sinne
dohte	tuo (kauempana oleva)
don biejjien	toissapäivänä
domhpe	maansiirtoauto
domtedh	tuntua; maistua
dovletje	entinen, muinainen	
dovne	vallan, aivan, kaikkiaan; myöten; myös, jopa
dovres	kallis
dovtesgierkie	tukikivi
duahpa	tupsu
duakan	taakse
duarsta	torstai
duarstabiejjegi	torstaisin
dubpelen	takana, tuolla puolen
dubpene	tuolla (kaukana)
dubpiebasse	tuonnemmaksi
dubpielisnie	tuonnempana
duekesne	takana
duelie	ole hyvä; siinä (on)
dueljie	talja
dulvies	tulviva
dunnie	siinä; tuolla
durrie	tunturien välinen laakso
dusnie	tuolla kaukana
duvhties	tiivis, tiheä
duvlie	siinä (on)
duvvene	rannikolla, vuonolla
dygne	vuorokausi
dæjman	viime vuonna
dæjpeles	hyvä, sopiva, mukava
dæjsta	tiistai
dængkodh	tilata
döömedh	tyhjentää
dööpmedh	tuomita
dööpmehtæjja	tuomari, tuomitsija
dööpmesovvedh	saada tuomio
döörkenes	vavistus, puistatus
dåajodh	taittaa, kerätä kotarisuja
dåajvoehtidh	luvata
dåaktere	lääkäri, tohtori
dåaktovre	lääkäri, tohtori
dåalvodh	jahdata, ajaa takaa; kuljettaa
dåamijes	kohtelias, kunnolla käyttäytyvä
dåaresth	poikki, yli
dåastodh	ottaa vastaan
dåastoehtidh	ottaa vastaan
dåehkie	tokka, lauma
dåelhpie	25 äyrin kolikko
dåemiedidh	menetellä, toimia, käyttäytyä
dåeriedidh	seurata (mukana), tulla mukaan
dåeriesmoere	kodan kynnyspuu
dågka	tupakka
dålle	tuli
dållesijjie	tulisija, nuotiopaikka
dålletje	pieni tuli
dån	sinä (sanan datne lyhyt muoto)
dåtnoeh	te kaksi
dåvna	tyyny
dåvnetråajjoe	untuvatakki
dåvvese	kauemmas rannasta
dåvvodh	korjata
davvodh	korjata
dåvvomesijjie	korjaamo, verstas
dååpmehke	taimen, tammukka
dåårrehtidh	hankkia, huolehtia
eadtjaldovvedh	innostua
eadtjohke	innokas, tarmokas
eajhnadovvedh	päättää, aikoa, saada päähänsä
ealehke	paha, työläs, ikävä; katkera (ruuasta)
eanna	aivan
earoeladtje	rehellinen
easkah	vasta
eatneme	maa
eavadidh	välittää
ebrie	sade
edtjedh	täytyä, pitää; aikoa
eejan jovjan	lohduta (ja kanna) minua
eejehtalledh	viettää aikaa, olla jouten
eejehtalleme	loma
eejehtidh	viettää aikaa, olla jouten, laiskotella
eejehtimmie	loma
eejhtegh	vanhemmat
eejsedh	panna puita nuotioon, lisätä lämpöä
eensi	taitava, kunnollinen
eensilaakan	kunnolla, hyvin
eeremes	ennen kaikkea
eerkedh	härnätä, ärsyttää
eevre	kokonaan, aivan
ektesne	yhdessä
ektelen	samaan suuntaan
ektine	yhdessä
elmie	taivas; huono sää
enn	kuin
ennje	vielä
faahketji	yhtäkkiä, saman tien
faahtele	(repun) kantohihna
faamoe	voima, tarmo
faatoes	puuttuva; puute; vaiva
faavroes	kaunis
fabrigkebarkije	tehdastyöläinen
faehtie	poron mahalaukku
faelhkiebaernie	sulhanen
Faepmie	Fatmomakke (Ruotsissa)
fahkedh	herätä
fealadidh	kulkea, liikkua	
fealadimmie	matka
fealloe	lauta
fealpere	parsinneula
fearhkasidh	sortua, valua
feete	vati
fehkiehtidh	havahtua
fiejlie	vika, virhe
fïereguhte	jokainen
fïerhne	jokainen
fïerhte	jokainen	
fïerske	tuore
fievsie	navetta
fïjfere	(koivun)pahka
fïjnedh	tulla pidätellyksi, jäädä kiinni
firredh	ravistaa
firrestidh	ravistella (vähän)
foeresjidh	ajaa, kuljettaa
fuehpesne	kiireessä; kiireinen
fuehpie	hoppu, kiire
fuehpiedidh	olla kiireinen, pitää kiirettä
fuehpiemisnie	kiireessä
fuelhkie	perhe, talonväki
fæjroe	tulitikku
föörhkedidh	nauraa
fåvhta	vouti
fååtesidh	puuttua
gaahkasjidh	katsella, töllöttää
gaahkoe	kakku, leipä
gaahkoesnaejrie	leipäviipale
gaahpasjidh	tuijottaa suu ammollaan; ammottaa avoimena
gaahtjedh	kilpailla; kiiruhtaa
gaahtjeme	kilpailu
gaahtoe	kissa
gaajeh	kovin, aivan; kova, kauhea
gaaje	kovin, aivan; kova, kauhea
gaajh	kovin, aivan; kova, kauhea
gaajhke	kaikki
gaajhkene lehkesne	kaikkialla, joka puolella
gaajhkesh	kaikki (yhdessä)
gaajhkesh dovnesh	kaikki (tyynni)	
gaaktsede	kahdeksas
gaale	karsina
gaalkedh	selvittää (verkkoa)
gaalla	aviomies
gaalloe	otsa
gaaloeværsjoe	kylmä kolea sadesää
gaamege	kenkä
gaamese	(poron) koipinahka
gaamhparidh	kaatua kumoon
gaamhparostedh	muksahtaa nurin
gaampe	kampa
gaampestidh	kammata (hiuksensa)
gaamsoe	kampsu, veripalttu
gaamtsehth	käsineittä
gaarhkedh	pakata, paketoida, sitoa
gaarkasidh	purkautua, valua pois
gaarkeles	selvä (vastakohta sotkuiselle)
gaaroe	sytyke, lastu
gaarvoe	vaate
gaasije	juoksutusmaha; juoksute
gaatodh	kadota, olla poissa, viipyä
gaatoelidh	kadota nopeasti
gaavalohke	kesy poro, joka helposti seuraa ihmistä
gaavalahke	kesy poro, joka helposti seuraa ihmistä
gaavelhkrievvie	kesy poro, joka helposti seuraa ihmistä
gaavhtan	vuoksi, tähden; suhteen
gaavmoe	luola, (ketun, karhun) pesä
gaavnedh	löytää
gaavnedidh	tavata, kohdata
gaavnjeres	soikea, pitkulainen
gaavtje	malja, astia
gaavtjetje	pieni malja, pieni astia
gabpe	tunturi, pyöreälakinen vuori
gabpeldidh	kellua
gadtjedh	pissata, kusta
gadtsedh	lusikoida
gadtsegarhke	veijari	
gaedtie	ranta
gaedtiebealesne	rannan puolella
gaegniedidh	kyetä, voida; kelvata
gaejnjele	kainalo
gaejpie	leuka
gaejvie	omia teitään kulkeva poro
gaejvielidh	koota takaisin omia teitään kulkevat porot
gaektsie	kahdeksan
gaeledh	kahlata
gaelpie	vasikka
gaeptie	(miehen) lapintakki 
gaerie	puuvati, (puu)astia
gaertene	(maa)tila
gaerviehtidh	hukata, kadottaa
gaervies	valmis
gahtjedh	pudota, varista
gahtjedidh	putoilla
gahtjehtalledh	pudottaa, pudotella
gahtjehtidh	kaataa, pudottaa; tappaa
gajhkedasse	kuivumaan
gajhkedh	kuivaa, kuivua
gajhkedidh	kuivattaa
gajhkesjidh	kuivattaa
gajhkestehtedh	kuiva(hu)ttaa
gajvedh	kiertää, mennä kiertotietä
galhkedh	lopettaa, saada valmiiksi
galhkove	päättäjäiset
gallanidh	tulla kylläiseksi
gallamidh	tulla kylläiseksi
gallasodtje	kylläinen
gallesh	monet
galmeguelie	pakastekala
galmetjaetsie	kylmä vesi
gamhtse	kinnas, hanska
gaptjedh	peittää
gaptjeldihkie	peitossa
garres	kova
garre	kova
garretjaetsie	viina
gaskebiejjie	päivällinen; keskipäivä
gaskejïjje	keskiyö
gaskese	väliin
gaskevåhkoe	keskiviikko
gaskevahka	keskiviikko
gaskoeh	keskellä, keskeltä
gasngese	kataja
gavtjedh	kaatua selälleen
geahpa	keuhko
geajnoe	tie
geajnoebarkije	tietyöläinen
geajnotje	pikkutie
gearketje	pikkukivi
geegke	tynnyri, astia
geehpehtidh	avata (ammolleen)
geehpes	kevyt, helppo
geehtedh	vahtia, pitää silmällä
geehtedidh	pitää varansa, varoa
geeles	kesy, taluisa
geelkedh	ojentaa, antaa
geelle	(avio)mies
geerjene	iloinen
geerve	huono (säästä); vaikea
geerve	aikuinen
geervedovvedh	aikuistua
geesjelihks	kunnollinen, kelpo
gejhkie	kuiva
gejhkiebearkoe	kuivattu liha
gejhkieguelie	kuivattu kala
gejhkielidh	raadella, repiä
geljies	väljä, leveä
gellie	(kuinka) monta; aika lailla
gellien aejkien	monta kertaa
gelmedh	palella; jäätyä
gertjie	koski, putous
gidtjh	näes
gie	kuka
gie joem	joku
giebnie	(kahvi)pannu, keittoastia
gïebredh	kääriä, pakata
gïebrelgovvedh	kietoutua, sotkeutua
giedtie	poroaita
giedtsies	kapea
gïehtelidh	puuhata, olla tekemässä
gïehtjedidh	katsella, tarkastella, tutkia
gïeje	jälki, kulkuura
gïejetje	pikkujälki
gïeke	käki
gïele	kieli
gïelehtadtje	mykkä
gïelekuvsje	kielikurssi
gïeltegs	jännittävä
gïemhpes	kiltti
gïengele	syvä
gïengeles	syvä
gïerhkeme	kehto, komsio
gieries	rakas
gierkie	kivi
gïertedh	sietää, kärsiä
gïerth mannem	anteeksi
giesedh	vetää
giesege	kesällä
giesie	kesä
giesieeejehtalleme	kesäloma
giesielaante	kesäalue, kesälaidun(maa)
gïete	käsi
gïetetje	kätönen, pikku käsi
gïetedalledh	käsitellä, käyttää
gïeteværjoe	ranneketju
gietjie	(köyden tms.) pää
gietskiebasse	lähemmäksi
gietskiedidh	ojentaa, tuoda lähemmäksi
gievlie	rengas
gïhpe	kerma
gïhpelaejpie	kermakakku
gïhpetje	hiukan kermaa
gihtjedh	kysyä, pyytää
gijhtedh	kiittää
gïjre	kevät
gïjredaelvie	kevättalvi
gïjredidh	tulla kevät
gïjrege	keväällä
gïjregiesie	kevätkesä
gïjreniestie	kevätteuras
gïknjele	kyynel
gïtnjele	kyynel
gïknjelsovvedh	kyyneltyä
gille	muutama
gilledidh	mennä makuulle
gilmetahke	pakastin
gilmehtidh	pakastaa, kylmettää
gïpte	puikkari; puinen verkon koho; alapaulan paino
gïrmedh	kehua
gïrre	kuori, kaarna
girrehke	3 1/3 – 4 1/3 vuotias urosporo
girtie	lentokone
gïsse	paksu
glijreldahkesne	koristeltuna
goebpere	sieni
goedtehtjidh	olla vasomassa
goegkerdidh	ryömiä, kontata
goejesjidh	kuoria, poistaa kuori (puusta)
goekedh	paistaa (aurinko, kuu)
goekedh	päivänpaiste
guakedh	päivänpaiste
goelke	(eläimen) karva
goelkegaamege	karvakenkä, turkiskenkä
goenehth	kova pakkanen
goenehthmåvhka	toppahousut, lämpöhousut
goenehthtråajja	toppatakki, lämpötakki
goenehthtjohpe	toppapipo, lämpöpipo
goenehthvaanhtse	toppalapanen, lämpölapanen
goeredh	seurata jälkiä
goerehtidh	kysellä
goerne	mylly
goerpe	epäonni
goerve	makkara
goese	kuusi(puu)
goeseråhtoe	kuusimetsä
goetsedh	kavuta, juosta
goetsedidh	juoksennella (eläin)	
goeve	joulukuu
goevledh	katsella, tarkastella, tuijottaa
gogkoe	mitä kautta, miltä kohdin, missä
gogka	mitä kautta, miltä kohdin, missä
goh	kun, kuin; sitten
gojhkelovvedh	olla janoinen
golke	lokakuu
golme	kolme
golmeluhkie	kolmekymmentä
golmesh	kolme ihmistä
golteladtedh	kuunnella, totella
goltelidh	kuunnella	
gon	ja (sanan gonnoeh lyhyt muoto)
gonnoeh	ja, yhdessä (toisen) kanssa
goske	kunnes
gosk	kunnes
gosse	minne; kun
gossehts	yskä
govhte	kuusi
govhtede	kuudes	
govjehkåbpoe	nopeampi
govledh	kuulla
govledh	kuulua
govlehtidh	tiedustella
govlijidh	(alkaa) kuulla
guaktegh	kaksi yhdessä
gualijes	kalaisa
guapa	sukka
guapamåvhkah	sukkahousut
guarjasjidh	maata (eläin)
guarkedh	ymmärtää
gubpene	missä
gubpede	mistä (suunnasta)
gudtsene	ole hyvä
gudtsien (aelties)	kiitoksia ruuasta
guedtedh	kantaa; vasoa (poro)
guehpere	kynsi; kopara
guejmie	kanssa; kumppani, toveri
gujmie	kanssa; kumppani, toveri
guektelen	kahtia; kahteen suuntaan
guektiengiertien	kaksin kerroin
guelehts	kalaton
guelie	kala
gueliebarkije	kalatyöntekijä
gueliebarkoesijjie	kalatehdas
gueliebïjle	kalaauto
gueliefealloe	kalalauta
gueliegaahkoeh	kalapullat
guelhtie	kylmä sää kesällä
guelmiedahke	peili
guelpie	lattia
guerkiehtidh	oivaltaa, hoksata
guesehke	4 1/3 – 5 1/3 vuotias urosporo
guessie	vieras
guevtele	tunturi(paljakka); järvenselkä
guhkene	kaukana
guhkiem	kauan
guhkie	pitkä
guhkies	pitkä
guhkie övtebe	kauan sitten
guhte	kuka
guhtsedh	valvoa
gujht	toki, kuitenkin
guksie	pahkakuppi, kuksa
guktemes laakan	mitenkään
guktie	kuinka, miten
guktieh	joten, niin että
gullievæhta	kultamitali
gullieværjoe	kultakoru
gurkedh	kaataa, valaa
gurkestidh	kaataa, valaa hiukan
gurredh	neuloa, kutoa
gusnie	missä
gussene	eipä kestä (kiittää); ole hyvä
gustie	mistä
guvvie	kuva
gyrhkesjidh	käydä kirkossa
gyrhkesjimmie	jumalanpalvelus
gyölledh	pysyä mukana
gyölleme	maksoittunut veri
gyönegs	kelvollinen, sopiva
gyösedh	laahata, laahautua
gyösedidh	laahata (jatkuvasti)
gæbjan	sairas
gæhtsan	roikkumassa
gæjhtoe	kiitos
gæljodh	huutaa
gænnah	kaan, kään
gærhkoe	kirkko
gærhkoenbealloe	kirkonkello
gærja	kirja
gærjabusse	kirja(sto)auto
gærjagåetie	kirjasto
gærjatjaelije	kirjailija
gæstoe	arkku
gævnjasjidh	riippua
gævnjodh	ripustaa
gævnjoestidh	ripustaa
göökte	kaksi
göökteluhkie	kaksikymmentä
göökten haaran	kahteen osaan, kahteen suuntaan
gööktesh	kaksin, kaksi yhdessä
göökti göökti	kaksitellen
gööledh	kalastaa
gööleme	kalastus
göölemekåarhte	kalastuskortti
göölestidh	kalastaa (vähäsen)
göölije	kalastaja
gööthsijjie	kotapaikka
gåabpa	kumpi(kaan)
gåabpatjahkh	kumpikin, molemmat
gåabph	minne, mihin
gåabregidh	käpristyä
gåajkoe	luo, suuntaan
gåajvodh	ammentaa, ottaa ruokaa
gåajvoestidh	ammentaa (vähäsen)
gåalmede	kolmas
gåalodh	palella
gåaltoe	lumipyry; lumivyöry
gåaltoehovme	(sakea) lumipyry
gåamalohke	(poron) umpisuoli
gåangkoeh	käyrä
gåaradidh	sopia, käydä, sujua
gåarodh	ommella
gåaroes	tyhjä
gåaskodh	herättää
gåassodh	olla kylässä, olla kestittävänä
gåassoehtidh	kestitä
gåassoehtæjja	kestitsijä, isäntä
gåatodh	laiduntaa
gåatome	laidun
gåatoemisnie	laiduntamassa
gåeblie	hanki, kinos
gåellie	missä (on)
gåessie	milloin
gåeskie	äidin isosisko
gåeskuve	sisarenlapsi (gåeskielle)
gåetie	talo, koti; kota
gåetiebarkoe	kotityö
gåetieietnie	emäntä
gåetieluhpie	majoitus, yösija
gåetieneastetje	kotitarveporo
gåetiesijjie	kotasija, talon paikka
gåhkasjidh	kaivata, pitää kauan kestävänä
gåhkese	kauas
gåhkoe	pituus
gåmma	vaimo; eukko
gåmmebe	vaimo
gåmpoe	väinönputkesta ja kirnupiimästä valmistettu ruoka
gåptoe	lapintakki
gårkasidh	vuotaa, valua
gårredidh	sitoa
gårreldihkie	sidottuna
gårroeh	vase(mmanpuoleine)n
gårroehbielie	vasen puoli
gåvva	hyvä, helppo
gåårvedidh	pukeutua
gåårveldihkie	pukeutuneena
gååvnesidh	löytyä, olla olemassa
haabpe	poron etujalan ylempi ydinluu
haaj	hei
haajpanidh	kadota, hävitä, häipyä
haampeldidh	huovata	
haarhtje	astia, taloustarvike
haaskoe	jäte, roska
haavjoelidh	hävitä, kadota (nopeasti)
haelsie	hopeakaulus (naisen puvussa)
haeniedidh	jankuttaa
haepkie	haukka
haermie	kulmakarvat
haevtie	aukko, kuilu, syvänne
hahtadidh	keksiä, hoksata, saada idea
hæhtadidh	keksiä, hoksata, saada idea
hahtjoe	mökki
hajkedh	juosta (eläin); heittää
hajkelidh	juosta (tiehensä)
hapsahtalledh	haistella; vainuta
hapse	haju
hapsoe	haju
harhtsoeh	kovakourainen, huolimaton
healma	hame
hearra	pappi
hearskoes	herkullinen
hearskoe	herkullinen
heektove	sata grammaa
heelsege	terveinen
heelsedh	sanoa terveisiä
heesedh	hajottaa, levittää ympäriinsä
hepsedh	haistaa
hepsiehtidh	haistella
herrehke	tikku, keppi, puikko, palikka
hïegke	henki
hïeje	häät
hïejeguvvie	hääkuva
hïejme	koti
hïelje	pyhä(päivä)
hierkie	hevonen
hïerpedh	säikähtää, pelästyä
hievnienviermie	hämähäkinseitti
hijven	hyvä, hyvin
hijvenlaakan	hyvin
hïngse	varpu
hingsedålle	varputuli
hinnedh	ehtiä, saada aikaiseksi
hoejhkesjidh	huutaa, huikata
hoksehtæjja	tarjoilija
horhtje	1 1/3 – 2 1/3 vuotias urosporo
hosbåanta	maanviljelijä
hov	toki; han, hän
huhtedh	haukkua
huinesne	surullinen, huolestunut
hurrie	(uros)teeri
hæhtjoe	mökki
hævvi	tietenkin
hööptedh	estää
håagke	ongenkoukku
håagk’staavra	ongenvapa
håagkije	onkija
håagkodh	onkia
håajje	kasa
håajsodh	kyetä, jaksaa
åajsodh	kyetä, jaksaa
håalodh	puhua, pitää puhe
håangke	suvanto, jurmu	
åangke	suvanto, jurmu	
hååkene	taipuvainen
ïebne	aines
ïedtje	into
iehkede	ilta
iehkedi	iltaisin
iehkedsbiejjie	iltapäivä
iehkedsbeapmoe	iltaruoka
ïentje	niitty
ïehterdahke	kylki(pala)
ietnie	emo
ietniengïele	äidinkieli
ihke	koska, joten
ijje	ei
iktesth	jatkuvasti
iktegisth	jatkuvasti
ikth	kerran
ikth gåessie	toisinaan, jonkin kerran
illedh	saada päätökseen, lopettaa, täyttää
inhtsie	erityisesti
isvelihke	hirveä, kauhea, kamala
jaa	kyllä
jaa nov maa	jo toki, kyllä vain
jaavoe	kyllä
jeavoe	kyllä
jaavvoe	jauho(t)
jaavvoeh	jauho(t)
jadtehtidh	laskea (verkkoja)
jaepie	vuosi
jaepieboelhke	vuodenaika
jaevrie	järvi
jaksedh	saavuttaa, ulottua
jakselidh	saavuttaa, tavoittaa (nopeasti)
jakseme mieresne	käsillä, lähellä
jaksoes	käsillä oleva, saavutettavissa oleva
jalhts	vaikka
jalke	tasainen
jallan	hädin tuskin
jalle	korkea
jïlle	korkea
jallh	tai, eli
jalloe	korkeus
jamhkelidh	sammuttaa; hävittää, tuhota
jamhkedh	sammua
jarhpoeh	vallaton, (rasa)villi
jarkoestidh	muuttaa, kääntää; vaihtaa (kieltä)
jarngesne	keskellä
jassije	paksu
jassijes	paksu
jeananidh	enetä, lisääntyä
jeatjah	toiset, muut
jeatjebh	toiset
jeenemes	enin
jeestere	hiiva
jeeste	hiiva
jerkiehtidh	kääntyä (nopeasti) takaisin 
jidtedh	irvistellä
jeedtedh	irvistellä
jiehtedh	sanoa
jïejkedh	epäröidä
jiekie	isän isoveli
jiekuve	pikkuveljen lapsi (jiekielle)
jieledh	elää
jieleme	elämä, elo
jielijeguvvie	elokuva
jienebh	enemmän, useammat
jïenehke	suurin osa
jïenge	jää
jïevege	peitto, peite
jïevehtasse	lakana
jih	ja
jijhtedh	itää, tulla esiin
jijhtelidh	tulla esiin, näkyviin
jijhtiestidh	tulla hiukan näkyviin
jïjje	yö
jïjjegåårtese	yösija; yönseutu
jijjehtovvedh	yöpyä; jäädä yön selkään
jïjjen	yöllä
jijmie	täti (isän tai äidin veljen vaimo)
jijmuve	aviomiehen veljen tai siskon lapsi (jijmielle)
jïjnjesh	moni, monet
jïjnje	paljon
jïjnjh	monet, paljon
jïjse	tunturipöllö
jïjtje	itse
jïjtjehke	varsinainen, itse
jijtjemsh	(he) itsensä
jijtse	oma
jïlle	korkea
jillehtje	länsipuoli
jïllemsgenhtseme	takakaihdin (poron sarvessa)
jillene	lännessä
jïlleskenteme	= jïllemsgenhtseme
jillielistie	lännestä, lännempää
jimkelidh	sammuttaa
jïpsadidh	kipsata
jïpse	kipsi
jirrede	huomispäivä
jirreden	huomenna
jïrreme	ydin(luu)
jis	puolestaan
jissehts	ohut
joe	jo
joejkedh	joikata
joejkestidh	joikaista
joekedidh	jakaa, jaella
joekoen	varsin, erityisen; erityinen
joevenidh	levitä, levittäytyä
johkebeala	joen ranta
johketje	pikkujoki
johtehtjidh	lähteä jutamaan
joknge	puolukka
joptse	keitto, velli
jorpe	pyöreä
jorpehke	pyöreä
jovje	vaaleanharmaa poro (vaaleampi kuin båavjoeh)
joevje	vaaleanharmaa poro (vaaleampi kuin båavjoeh)
jovkedh	juoda
jovkemes	juoma, juotava
jovnesåhkoeh	juhannus
jovven	jo vain
jualketje	pikku jalka
juassah	aikaisemmin, sitten
juekedh	jakaa
juelkie	jalka
jueskebe	kylmempi (sää)
jueskie	kylmä sää
juhtedh	muuttaa, siirtyä, kulkea
juhteles	nopea kulkemaan, luistava
juhtele	nopea kulkemaan, luistava
juhtiehtidh	auttaa muuttamaan, auttaa siirtymään
juktie	niin että
jurjiehtidh	tehdä, laittaa, valmistaa (ruokaa)
juvre	(peto)eläin
jyöne	eno, (mies)serkku
jöödtedh	jestas
jöömmetjh	kaksoset
jöörtedh	oleskella, viipyä, pysytellä
jyörtedh	oleskella, viipyä, pysytellä
jåarhkeskuvle	lukio
jåasoeh	tyhmä
jåaskoestidh	jäähtyä vähän
jåhtajidh	lähteä liikkeelle
jårrehtidh	kääntää ylösalaisin, tosinpäin
jåvle	joulu
jåvleaajja	jouluukko, joulupukki
jåvlebiejjie	joulupäivä
jåvleeejehtalleme	joululoma
jåvlegoese	joulukuusi
jåvlekåarhte	joulukortti
jåvlemoere	joulupuu
jåvlevadtese	joululahja
jååktan	eilen
jååktetjeiehkeden	eilisiltana
jåårke	vastapäätä
kaanne	ehkä
kaarhte	kartta
kaarre	mies
kilovmeter	kilometri
klaahka	sauva
klaahtoehtidh	leikkiä, pitää hauskaa	
klaasetjelmieh	silmälasit
klaase	ikkuna
klaasse	luokka
klaerie	väri
klaeriedidh	värjätä, värittää
klajkoehtidh	kukkua
klienjiedidh	välkkyä
klovperdidh	olla lumisokea
klovse	albiinoporo; vaalea(hiuksinen)
klåenkiehtidh	soida (kirkonkello)
klååmsehth (vearelde)	epävakainen sää, jolloin savu tulee sisään
konhtovre	konttori, toimisto
konhtovrebarkije	toimistotyöntekijä
konhtovrebarkoe	toimistotyö
konhtovreåvtehke	toimistopäällikkö
konhtovreviehkie	toimistoapulainen
kraanna	naapuri	
kraesie	heinä; kasvi
kraevies	harmaa
kraeviesjovje	harmaanvalkoinen poro
krïbpesjidh	vaatia
krievvie	poroelo, porotokka
krïjhte	liitu
krinngehke	vikkelästi (edestakaisin)
krist’aehtjie	kummisetä
kristesovvedh	tulla kastetuksi, saada kaste
krist’ietnie	kummitäti
kroehkedh	kaivaa; haudata; raaputtaa
kroehkememaasjina	kaivinkone
kroenes	vihreä
krovhte	pata
kruana	vihreä
kruepies	karkea
kruepemes	karkein
kröövvehtidh	taivuttaa, käyristää
kråane	nurkka
kråavhkasjidh	maata käpertyneenä
kråavvegidh	käyristyä
kråvna	kruunu
kråvnoe	kruunu
kråånedidh	vihertää, tulla vihreäksi
kuvsjh	kurssi(t)
kveita	ruijanpallas
kåahpe	kuppi
kåalhta	paistinpannu
kåarhte	kortti
kåava	porstua, eteinen
kåvrohte	unenpöpperöinen
laadtege	hilla, suomuurain
laadtegenlaste	suomuuraimen lehti
laadthbïekere	hillasuo
laadthpluevie	hillasuo
laahkoe	sukulaisuussana
laake	laki
laakan	lailla, tapaan; kaltainen
laante	maa, alue
laanteburriekonhtovre	maanviljelyskonttori
laapestidh	levittäytyä (savu tai sumu)
laatege	latu; moottorikelkan jälki
laavkodh	kylvettää; kastaa
laavkome	kaste
laavlodh	laulaa
laavloe	laulu
laavlomegærja	laulukirja
laavadahke	lauantai
laavvadahke	lauantai
ladtetje	pikkulintu
laehpedh	jättää
laedtie	maanviljelijä, talollinen, eisaamelainen
laejhtedh	moittia
laejkie	lanka
laejpie	litteä leipä
laejpietjaalege	leiväntekoohje, resepti
laetjedh	sijata vuode
laatjodh	sijata vuode
laevie	sukulainen, pikkuserkku
laeviehkadtjh	pikkuserkut (keskenään)	
laeviestidh	nimittää, puhutella laevieksi
lahkaskidh	onnistua
lahkoe	onni
lahkoehtidh	onnitella, toivottaa onnea
laste	lehti
latjkedh	sopia (keskenään)
leahpa	matkalippu
leavadimmie	melu, metelöinti
leavloe	paino
ledtie	lintu
ledtjie	onkohan
leejjedh	vuokrata
leekedidh	teurastaa useita eläimiä
leekedæjja	teurastaja
leeredh	opettaa
leerehtidh	opettaa (jotakin)
leessedh	lastata, kuormata
leessemebijle	kuormaauto
librie	maksa
liebnedh	kaataa, valaa
lïegkedidh	levätä
lïegkestidh	levähtää
liehtebe	halvempi
liehties	halpa
liejpie	leppä
lïeme	liemi
liemkede	leuto (sää); suoja(sää, keli)
lïenedidh	lämmittää t. jäähdyttää sopivan lämpimäksi
lientsie	nimismies
lïepse	mahapaita, mahan ympärillä oleva rasva
lïeredh	oppia
lïgkedh	peittyä (lumeen)
lïhke	lähellä
lihphgierkie	kivi jossa on kieleke
lihpie	kallionkieleke
lihtie	astia
lihtievåarhkoe	astiakaappi
lïhtse	jäsen, nivel, (selkä)nikama
lïhtsh	selkäranka
lijhtere	litra
lijnie	liina
lijniegaalloe	valkopäinen poro
lijrehtidh	taluttaa
lilla	liila(nvärinen)
lissine	lisäksi
loedte	(porojen) kulkuura lumessa
loekte	lahti
loese	lohi
loevenidh	päästä irti, irrota
loevtenjidtjieh	utareet, jotka ovat niin lähekkäin että ne voi lypsää yhtaikaa
lohkedh	lukea
lohkemegærja	lukukirja
lohkemesh	lukeminen, lukemiset
lohkije	lukija
lohkehtæjja	opettaja
lopme	lumi
lovvedh	kastua
lovvedidh	paneutua makuulle lepäämään (poro)
lovve	märkä
lovves	märkä
luajhtadidh	laskea (aurinko), laskeutua
luajhtasovvedh	päästä irti
luehkie	kansi
luejhtedh	päästää (irti)
luepkedh	halkaista
luhkie	kymmenen
luhkiegåalmede	kolmastoista
luhkiemubpie	kahdestoista
luhkievoestes	yhdestoista
luhpie	lupa, lupaus; sallittu
luhpiedidh	luvata
luhpiehtidh	luvata, myöntyä
luste	huvi(tus); hauska
lusten gaavhtan	huvin vuoksi
lustestalledh	huvitella
lutnjedh	nostaa
luvlielisnie	idempänä
luvnie	luona
luvrege	tottelevainen
lyjhkedh	rakastaa, pitää (jostakin)
lyövlehke	raskas, painava
læhkoe	onni
læjhkan	kuitenkin
lööhpe	vasana tiineeksi tullut poro
lööke	sipuli
löönedh	lainata
löönestidh	lainata vähäksi aikaa
lööpkedh	halkaista (liha tai kala)
löövedh	irrottaa, ottaa irti	
lööveldidh	irrottaa, ottaa irti
löövje	tee
löövles	painava, raskas, vaikea
låadtodh	halkaista, halkoa
låajtoe	loito, kodan (sivustan) lattia
låamme	tasku
loemme	tasku
låavthgåetie	loudekota
låedtjie	tyyni (sää)
låemtie	kesy
låemties	kesy
låepiehtidh	vetää jalkaan (kenkä sitomatta nauhoja)
låapoehtidh	vetää jalkaan (kenkä sitomatta nauhoja)
låevtedh	hyökätä kimppuun, iskeä
låevtedh	kattaa, peittää louteella
låhkede	kymmenes
låhkoe	lukukappale
låpsoedahke	kosteus
låvledhvearelde	itätuuli
låvnedh	nousta ylös
lååjedidh	sarastaa, koittaa (päivä)
maa	kyllä, kai, toki
maadteraahka	esiäiti
maadteraajja	esiisä
maadtere	kodan seinän reuna
maadthgietjie	tyviosa
maadthskuvle	peruskoulu
maahtoe	taito, oppi, opetus
maaje	tosin, vaikkakin
maajetjh	onneksi
maajke	lämmin auringonpaisteeton sää
maajsoe	taakka, kantamus
maake	lanko, setä (tädin tai isosiskon aviomies)
maakenåhke	5 1/3 – 6 1/3 vuotias urosporo
maaketje	vaimon pikkuveli tai sisaren poika
maaksoe	maksu
maales	ateria
maalese	ateria
maam joem	yhtä ja toista
maana	lapsi
maanabaelie	lapsuusaika
maanageehtije	lastenhoitaja, lastenvahti
maanagïerte	lastentarha
maanetje	pikkulapsi
maarhke	(onki)mato
maarhkelihtie	matoastia
maaskedh	sekaantua, sotkeutua
maaskenidh	sotkeutua
madtan	huonosti, niukasti
madtan laakan	huonosti, juuri ja juuri	
madtege	niukka, kehnonlainen
mådtege	niukka, kehnonlainen
madtjeldehtedh	ilahduttaa
madtjeles	iloinen, tyytyväinen
maehtedh	osata
maehtele	taitava
maehteles	taitava
maehtetje	taitava
maeksedh	maksaa	
maelie	(eläimen) veri; (koivun) mahla
maeliegaamsoe	kampsu, veripalttu
maeliegoerve	verimakkara
maereles	taitava, onnekas
maedeles	taitava, onnekas
magkere	mikä, millainen
magkeres	mikä, millainen
mah	ko(han), kö(hän)
mahte	melkein, lähes
man jïjnjh	kuinka monta, kuinka paljon
man åvteste	minkä tähden
mannasinie	miksi, mitä varten
manne	minä
manne mån	minäpä	
marngedh	kääntyä takaisin
marngestidh	vääntää, taittaa kaksinkerroin, kääriä ylös
maskastidh	ommella kiinni, ommella umpeen
måskoestidh	ommella kiinni, ommella umpeen
meajvadovvedh	uupua
mearan	kunnes, sillä aikaa kun
mearhkodh	merkitä (vasoja)
mearoe	meri
measetje	pikkuvasa
measije	vasaisa, paljon vasoja
meatan	mukana, mukaan
mejtie	ko, kö
men	mutta
mennie mieresne	paljonko, missä määrin
mestie	mistä
miedtedh	härnätä, ärsyttää; erehtyä, tehdä väärin
mielhkie	maito
mïelke	rinta(liha)
mïerhke	merkki
mïerhkesjidh	merkitä (vasoja)
miesehke	vaadin, jolla on vasa
miesie	vasa
mietenh	mäti
mietie	myöten	
mïetsedh	napsaa, naksua
mïetske	laho, mätä; mätäkuu; elokuu
mïetskedh	lahota
mij	mikä
mijakt	yksi tai toinen, jokin
milkedh	syödä ja talloa pilalle
milkesovvedh	tulla syödyksi ja tallotuksi
mïnnedh	mennä; käydä
mïnnedidh	käydä useasti, kuljeskella
minngelesmiesie	naaraspuolinen vasa
minngemes	lopuksi	
minngesne	perässä	
minngiegietjie	loppu(osa, pää)
minngiestaebnie	(veneen) perävannas
minudte	minuutti
minuse	miinus
mirhkekruana	tummanvihreä
miste	vahingossa, tarkoittamatta
modtovresaakoe	moottorisaha
moehrele	isosiskon lapsi (muahralle)
moenedh	sanoa, kertoa, virkkaa
moenedidh	arvata
moenjehth	selkiytyvä sää
moere	puu
moeretje	vähän (poltto)puita
mohte	mutta, vaan
mojhtelidh	muistella
mojhtes	muisto, muisti
mojhtese	muisto, muisti
mojjesjidh	hymyillä
motovre	moottori
muadta	turkis(vaate), peski
muahra	täti, äidin pikkusisko
muarjetjh	vähän marjoja
mubpehte	toisesta	
mubpie	toinen
muerkiestidh	kehrätä (kissa)
mujhtedh	muistaa
mullie	pilvinen sää
munnie	muna
murreds	viihtyisä, mukava
murriedidh	viihtyä, voida hyvin
murrie	viihtyisä, rauhaisa
murries	viihtyisä, rauhaisa
musigke	musiikki
mutskedh	olla huono sää
mutskiehtidh	muuttua huonoksi (sää)
muvhte	muutama, joku
myövhkes	pehmeä
möövkes	pehmeä
mænngan	myöhemmin, jälkeen
mænnja	miniä
mööledh	mitata, ottaa mitta
möölege	mitta
möörjedh	poimia marjoja
måanta	maanantai
måarehks	vihainen
måaroe	ruoto; luu
mådtan	huono(kuntoinen)
mådtsoestidh	kääntää (sisäpuoli ulkopuoleksi)
måedtie	moni, muutama
måekie	sadekuuro
måerie	viha
måjhtajidh	(alkaa) muistaa
målsodh	vaihtaa
mån	minä (sanan manne lyhyt muoto)
månnja	käly
månnoeh	me kaksi
måskoestjåelie	umpisuoli	
måsnoes	suuttunut, pahantuulinen
måvhka	housut
måvhkah	housut
naa	kovin, varsin, melko
naajedh	leikata, kaivertaa
naaken	joku
naakene	joku
naaloe	(pyöreä) neula
naan	jokin, mikään
naan gille	jokunen, muutama
naarpehke	ahne, perso, himokas
naatskedh	käydä kimppuun
naavjodh	havaita	
naehkie	nahka; kalanpää
naehpie	nappo, lypsyastia
naemhtie	näin
naepie	napa
nagke	siis
nahkasjidh	jaksaa, voida, kyetä, tulla toimeen
nahkeren	uninen, väsynyt
nahkestidh	nukahtaa
nahkeren	väsynyt
namhtegh	ilman
nannoes	vahva, luja
nænnoes	vahva, luja
napsh	siis, kin
narhkelidh	estää poroja menemästä, ohjata toiseen suuntaan
nastehtehtedh	kohentaa tulta, siirtää puita lähemmäs nuotiossa
nastemeklaahka	tulenkohennuskeppi, hiilihanko
neapede	sisaren lapsi (enolle)
neebnedh	mainita
nehkiehtidh	työntää, tönäistä
nejpie	veitsi
nelhtie	päältä
nelnie	päällä
nïere	hätä
nïejte	tyttö
nïejtetje	tyttönen
niestie	teurasporo; eväs
niestiesvoesse	eväspussi
nille	päälle
nimhtie	näin, täten, tällä tavoin, siten, sitten
nïrre	työkalun varsi, kädensija
njaakedh	hiipiä (luokse)
njaamelijnie	pyyheliina
njaamedh	kuivata, pyyhkiä
njabpestidh	luiskahtaa
njaelkie	maukas, hyvänmakuinen
njaelkies	maukas, hyvänmakuinen
njaelmie	suu
njalhkedigks	liukas
njamma	nänni
njammedh	imeä
njeajkedh	vyöryä, valua alas
njeerpes	ohut, laiha
njeeruve	ruohoa kasvava ylätasanko
njeervedh	jauhaa
njelledh	nylkeä; irrottaa tuohta
njielje	neljä
nieljie	neljä
njieljie	neljä
njieljede	neljäs
njieljehts	neljännes
nj̈ietsege	poron takajalan alempi ydinluu
njilledh	nylkeä; irrottaa, kiskoa (tuohta)
njoeje	rinne, myötämäki
njoektjeme	kieli
njoelkedasse	sääntö
njoetjeles	taipuisa, pehmeä
njoetsedh	kypsyä; pehmetä (kala kun se on liossa)
njoetseldh	kypsynyt, kypsä
njoevege	kalanperkeet, sisälmykset
njolledh	irrota (puun kuori)
njylledh	irrota (puun kuori)
njuana	niemeke (joenhaarojen välissä)
njuenie	nenä; turpa
njulhtjedh	hypätä
njulhtjestidh	hypähtää
njuvvie	virta
njæssoe	lämpimähkö auringonpaisteinen sää
njööredidh	nousta (auringosta), koittaa
njåalodh	nuolla
njåemele	jänis
njåetsie	hartiaviitta
njårkoehtidh	viheltää
njååjte	rinne, myötämäki
noeledh	irrottaa, purkaa, avata pakkauksesta, riisua
noelestidh	riisua nopeasti
noere	nuori
noerhtelen	pohjoispuolella
noerhtelistie	pohjoisesta, pohjoisempaa
noerhteraedtie	(tunturin, vuoren) pohjoispuoli, sivu
noerhtese	pohjoiseen päin
noeve	sieni
noh	ja
nojjedidh	hymyillä
nomme	nimi
nommelaehpie	yli 6 1/3 vuotias urosporo
nommelaehpije	yli 6 1/3 vuotias urosporo
nommestehtedh	kutsua nimeltä
nossedh	puuhailla, touhuta
nov	niin, kyllä
novh	niin, kyllä
novh amma	toki
novh hævvi	tietenkin, luonnollisesti
novh maa	jo toki, niin kyllä
nualan	alle
nuarvan	likainen, roskainen
nuehtie	nuotta
nuekies	kyllin, kylliksi
nuelesne	alla, alapuolella
nueleste	alta
nuepie	tilaisuus, mahdollisuus
nuerebe	nuorempi
nulle	nolla
nyjsenæjja	nainen
nyöjhkedh	kieltää; kieltäytyä
nænnoes	vahva, voimakas
nööredh	ehtiä, joutaa
Nöörje	Norja
nåake	huono
nåhkedh	loppua
nåhtadidh	hyödyttää; käyttää
nåljode	sarveton, nupo
nåå	niinpä
nåånåå	heihei
nååte	vaimon veli tai sisaren tytär 
nåts	entäpä
nååts	entäpä
ohtje	pieni
ohtjegåetie	vessa
ohtsedh	etsiä, hakea
ohtsedidh	etsiä
ohtseme	hakemus
ohtsemebiejjie	hakuaika, määräpäivä
ojhte	juuri (niin)
okse	ovi
oktegh	yksin
olkese	ulos
olles	jottei
onne	pieni
onnegåetie	vessa
onnevielle	pikkuveli
onneåabpa	pikkusisko
onterdidh	miettiä, ihmetellä
orre	uusi
orrejaepie	uusi vuosi
orresistie	uudestaan
orrestehtedh	uudistaa
orrijidh	jäädä paikalleen, pysähtyä; lopettaa
ostedalledh	viettää aikaa
otnerasse	kotakorva (kaareva kodan rankapuu)
ovjuvre	peto(eläin)
ov jösses	jestas sentään
ovledh	tulehtua	
ovmese	kaikenlainen
ovnohkens	tuntematon
ovnuhtege	paha, tuhma; hyödytön
ov	aivan	
ovve	aivan	
paagke	paketti
paanne	(paistin)pannu
paehpere	paperi
peennagåetie	penaali, kynäkotelo
peara	peruna
peehkedh	pakata
plaave	sininen
plaerie	(sanoma)lehti
pleasoeh	hidas huomaamaan, huononäköinen
plïehtje	laakea
plïehtjegaerie	lautanen
pliejhkies	kalpea
pluahta	lautta
pluevie	suo
plusse	plus(sa)
plæjjohke	lyijykynä
praare	jyrkkä
pradtjedh	rehkiä, rasittaa itseään
prïejhke	saarna
prievie	kirje
prïhtjegadtje	vähän kahvia
prïhtjege	kahvi(juoma)
prïhtjegh	kahvi(pavut, jauhe)
prïhtjhgiebnie	kahvipannu
prïhtjhgåetie	kahvila	
provhkedh	pitää tapana; käyttää
provne	ruskea
provnedh	punoa yhteen
provnelaaketje	ruskeansävyinen
provneldahke	punos
pruvredh	mennä naimisiin
pruvre	häät
pruvres	naimisissa
pruvrese	morsian
pruvvie	silta
pryövedh	kokeilla, yrittää
pæhperh	pippuri
påajke	poika
pååjke	poika
påaske	pääsiäinen
påaste	posti
påastegåetie	postitalo
raahkeldidh	kuljeksia, vetelehtiä, viettää aikaa
raahkoestidh	onkia jään alta, pilkkiä
raajan	asti, saakka
raajnes	puhdas
raajne	puhdas
raajsedh	haljeta
raakte	juuri, aivan, lähes
raakth	juuri, aivan, lähes
raarhkoe	poroerotus
raavnije	pihlaja
raavre	rautu
radijove	radio
radtjoes	reipas, tehokas
raedtie	reuna, syrjä
raeffie	rauha
raejeste	alkaen
raejkie	reikä
raejkien	pitkin
raejkiedidh	rei’ittää
raejrie	ukkonen
raejrienvearelde	ukonilma, ukkossää
raerhkedh	erottaa poroja
raerie	neuvo(sto)
raerievedtije	neuvoja, konsulentti
rahtjedh	pyrkiä (menemään)
rastah	poikki, yli
ravve	takamus
reagka	rengas; suopungin sarvikiela
reajnoe	petovaara (kun on peto poroja ahdistelemassa)
reakadidh	syntyä
reakasovvedh	syntyä
reakedsbiejjie	syntymäpäivä
reakta	oikeus
reaktaaamhtese	oikeusjuttu
reaktaåejvie	(pää)tuomari
reaktoe	totta, oikein; oikeus, totuus
redaktööre	toimittaja
reejnedh	perata; kuoria
reejredh	telmiä, leikkiä (äänekkäästi)
rehpie	katto
riehpene	räppänä, (kodan) savuaukko
riejries	(lähtö)valmis
rïeksege	riekko
rïekte	suoraan; suora
riepie	kettu
riepieråaksoe	kettunaaras
rïesegh	koristeet; kukat
rïeseldahke	koriste
rïevhkestidh	polttaa tupakkaa
rïevtje	kylmä sateinen sää
raavtje	kylmä sateinen sää
rïgkesjidh	soida
rïhpestidh	avata
rijtedh	panna, pistää (jonnekin)
rikti	oikein, hyvin; kunnossa (oleva)
ringkedh	soittaa puhelimella
rïrresjidh	parkita
rïsnjedh	kerätä (polttopuita)
risjnedh	kerätä (polttopuita)
rissie	tihkusade
roehtedh	juosta (kahdella jalalla)
roehtse	juuri
roevtedh	palaa, saada liikaa aurinkoa
rohkejaavvoe	ruisjauho(t)
rohkejaavvoeh	ruisjauho(t)
Romsa	Tromssa
rovnegs	kummallinen, erikoinen, outo
ruaksja	paisti, reisi
rudtje	selkä
rudtjemåaroe	selkäruoto
ruerhkie	seisoneesta poron verestä erottunut hera
ruevtie	rauta
ruevtieraajroe	rautatie	
ruffie	kesäkuu
ryöhkedh	ulottua; kestää (ajasta)
ryöjnesjidh	paimentaa
ryöjnesjæjja	(poro)paimen
ryöjredidh	valmistautua
ryöknedh	laskea
ryöknemegærja	laskuvihko, kirja
ryöknesovveme	laskettuna
ræjhkoes	rikas
röönjedh	raivata
rööpses	punainen
rööpseslaaketje	punertava
röövre	pyssy
råahke	työporo, vetoporo
råakedh	tavata, kohdata
råanjedh	sataa kaatamalla
råanjedimmie	kaatosade
råantjoe	kastroitu poro, härkä(poro)
råate	ilves
råavkedh	roukua	
råavkoe	rouko, talja
råhtoe	tiheä (kuusi)metsä
råtnoe	runo(vaadin), maho vaadin
saajve	maahinen
saakoe	saha
saalege	aukko, kuilu
saalehte	saalis
saalhtetjh	hiukan suolaa
saalje	paju, raita
saalmegærja	virsikirja
saarnodh	sanoa, kertoa
saarnoeh jeahtah	sanopa se
saatnan	tosi, totta
saedtie	hiekka
saedtietjeallere	maakellari
saedtieåårke	hiekkaharjanne
saehtedh	kuljettaa, viedä; lähettää pois
saejrie	sei, seiti
saejriedidh	särkeä
saelhtie	suola
saelhtieh	suola
saemie	saame(lainen)
saemiestidh	puhua saamea
saernie	uutinen	
saevrie	kostea, irtonainen ja karkea kevätlumi
sagki	kovasti, kovin
sagke	kovasti, kovin
salkedh	harsia
samhkedh	autereinen sää
sarva	hirvasporo
satne	hän (itse)
seadtoe	rauha
seadtoes	rauhallinen, rauhaisa
seakoes	käheä
seakoe	käheä
sealadidh	kuolla (ihmisestä)
sealkedh	laskea maihin (vene), lipua rantaan
seamma	sama(nlainen)
seammaplïeres	samanlainen, samankaltainen, samannäköinen
seangkoe	sänky
seangkoegaptjese	sängynpeitto
seasa	täti, isän sisko
seedtedh	lähettää
seenhte	myöhä(inen)
sïejme	siima
sïejpe	susi
siejpie	häntä, pyrstö
siejpiegietjie	hännänpää
siekierdidh	kaivata, haluta syödä
sïelkedh	lipua rantaan
sïemes	yksimielinen
sïerkestahke	pajukko
sïerrenohke	vieras
sïesele	veljen lapsi (seasalle)
sïevehtidh	vilkuttaa
sigkedh	vetää
sigkestidh	vetäistä
sih	he (lyhyt muoto sanasta sijjieh)
sïjhtedh	haluta
sijhtie	hylly; säilytysteline, lava
sijjie	paikka, sija
sïjse	sisään
sïjte	siita, lapinkylä
sïlle	syli; askel (pituusmittana)
sïlpe	hopea
sïlpebeetnegh	hopearahat
sïlpevæhta	hopeamitali
sïmmedh	kuiskata
sinsitnien	toistensa	
sirrie	mustikka
sïrve	lammas
sisnie	sisällä
sissie	hiha
sistie	sisältä
sisætnan	toisillensa; toisiinsa
sjaampove	shampoo
sjaavede	hiljaa, ääneti
sjaavedh	hiljaa, ääneti
sjalkedh	sulaa
sjeakodh	siivota, järjestää, kerätä kokoon
sjeavodh	hiljaa, ääneti
sjeavohth	hiljaa, ääneti
sjelhkiedidh	hupsia, laskea leikkiä
sjeltie	kaupunki, kirkonkylä; markkinat
sjïdtedh	tulla (joksikin); kasvaa; joutua (tekemään)
sjïjle	hiillos
sjilkehtidh	sulattaa
sjïere	erillinen, oma
sjïehtedh	sopia
sjiehteles	sopiva
sjiehtesjidh	sovittaa (paikalleen)
sjovne	kotiapulainen, piika
sjuevnjede	hämärä
sjuevneds	hämärä
sjædtoe	kasvi
sjædtoes	kasvillisuuden peittämä
sjæjsjalidh	ratkaista, päättää tehdä jotakin
sjöövedh	sekoittaa
sjåarhtoe	paita
sjåavoehtidh	hämmentää, sekoittaa
skaadtje	lurjus
skaahkanidh	säikähtää, pelästyä
skaarja	sakset
skaavhtege	laatikko
skarredh	soida
skeeledh	kuoria
skiblie	kalansuomu
skiehrie	poski(pää)
skïemtjebijle	ambulanssi
skïemtjebåara	paarit
skïemtjegåetie	sairaala
skïemtjes	sairas, kipeä
skïemtjesyjhtere	sairaanhoitaja
skïemtjesåjhtere	sairaanhoitaja
skïeredahke	rykimäaika, porojen kiimaaika
skïerke	kirkas, pilvetön
skilkedh	tuhota, turmella
skodtedh	kiiruhtaa
skoerhtje	(koiran)pentu
skovhte	kyyti
skovhtjedh	telmiä, huvitella, pitää hauskaa
skreepedh	raaputtaa irti
skreepestidh	raaputtaa irti (nopeasti)
skruvve	ruuvi
skuarhtjadidh	penikoida
skubpedh	harjata, pestä; hiertää
skubpehke	pyyhekumi
skugkie	varjo, hahmo, haamu, kummitus
skuvle	koulu
skuvledh	pestä, huuhtoa
skuvlehieme	asuntola
skuvlejaepie	kouluvuosi
skuvlemaana	koululainen
skuvtere	moottorikelkka
skovtere	moottorikelkka
skæhtjoe	puuvaja, liiteri
skåajje	metsä
skåake	metsä
skåaknge	nuori vaadin (t. hirvilehmä)
skoeknge	nuori vaadin (t. hirvilehmä)
skåape	kaappi
skåave	(pikku)kenkä
skåltoe	syy, vika
skålta	syy, vika
slaahpoe	poron selkäjänne
slaamedh	luhistua, romahtaa
slahkode	vinossa
slahtjan	rikki, epäkunnossa
slahtjegidh	hajota
slajpan	longollaan, lerpallaan; huolimattomasti pantuna
slapmoehgåetie	matala ja leveä kota
slavtjeguelie	vasta kutenut kala
sleagran	likainen
sleehpedh 	punoa suonilankaa poron selkäjänteestä
sleengkedh	heittää
sleevhkedh	heittää, paiskata pois
sliehtie	räntä
sliehtieelmie	räntäsade
slïekte	suku(lainen)
slienghkiehtidh	laskeutua (polvilleen), polvistua
slijredh	heittää (pois)
slïmhpe	haava, rakkula huulessa
slognestidh	valehdella
slubpie	tohveli
sluvke	viehe
slærra	reki
smaave	pieni
smaavegualetje	pikkukala
smalhtjaridh	mennä rikki
smeejvedh	paloitella (ruhoa)
smååhkedh	maistaa
smååhkestidh	maistaa vähäsen
snaabrestidh	kaluta, syödä vähäsen
snaejrie	viipale, kappale
sneehpebe 	nopeampi
sneehpes	nopea
snjaltje	heinäkuu
snjaltjh	karvattomat kengät
snjarhtja	juoksutusmaha; juoksute
snjeara	hiiri
snjåame	jänis
snuehtie	orastava heinä
snorre	pieni urosporo
snæhkere	puuseppä
snåvhtoe	sormainen, kerralla kammattava määrä kenkäheinää
snåvhroe	sormainen, kerralla kammattava määrä kenkäheinää
soehpenje	suopunki
soehpenjereagka	suopungin sarvikiela
soejmetje	hissukseen, pikku hiljaa, rauhallisesti
soejmetji	hissukseen, pikku hiljaa, rauhallisesti
soejmi	hissukseen, pikku hiljaa, rauhallisesti
soelmeh	(väli)ovi
soene	jänne; suonilanka
soerme	sormi
soermegåetie	sormustin
soeve	savu
soevestehted	savustaa
soevestidh	savustaa
soevine	likainen
sohkerelaejpie	(sokeri)kakku
sohpedh	kaapia, irrottaa lihaa luusta
sojjedh	taipua
sontere	vasten
soptsestidh	puhua, kertoa
sovhtine	vilustunut
sovkedh	soutaa
sovkijahtjedh	alkaa soutaa
sovkije	soutaja
sovmedh	olettaa, arvella, epäillä
spaajhte	nopeasti, reippaasti
spaarra	sinka, pingotusvarpa (tikku, jolla eläimen nahka t.
	kuivattava kala pingotetaan levälleen)
spaarretje	pieni sinka
spealadidh	soittaa
speedtjedh	hajoittaa 
speenedh	peittää (koipinahka) lastuilla (pingotusta varten)
speerredh 	levittää kuivumaan
spidtje	maatila, uudisasutus
spïjhke	naula
spæjhkere	naula
spijhkierdidh	naulata
staajne	maho vaadin, tainakka
staajnehke	maho vaadin, tainakka
staake	käytössä oleva, selvästi näkyvä (polku)
staaloe	staalo, peikko, jättiläinen
staaran	oikein
staare	kaupunki
stasjovne	asema
staasjovne	asema
staavra	vapa
steegkedh	sulkea
steeredh	pitää (kiinni, paikallaan)
steerestidh	ottaa, pitää kiinni
stïeres	valmis
stilledh	lähettää, käskeä, panna tekemään
stoere	iso
stoerre	iso
stoeregeajnoe	maantie
stoerregeajnoe	maantie
stoerevielle	isoveli
stoerrevielle	isoveli
stoereåabpa	isosisko
stoerreåabpa	isosisko
stompeldidh	kompuroida
stovle	tuoli
straavvedh	olla huolissaan, pelätä
stratjketje	pieni ruiske
strerkies	säikähtänyt
strerkiestidh	säikähtää, olla huolestunut
stroehte	jouluaatto
stroehtebiejjie	jouluaatto
struvkestidh	vetäistä, nykäistä
stuerebe	suurempi
stuhtje	pieni porotokka; palanen, kappale
stujmie	meteli, metakka
stuvredh	ohjata
stænkodh	vahvistua
stööredh	häiritä
stööves	rauhallinen
ståamhpe	kanto
ståapoe	talo, tupa
ståvroe	hallinto
stååkedidh	leikkiä
stååkedimmie	leikki
suaja	suojaisa; tuulensuoja
suajas	suojaisa; tuulensuoja
suehpede	toukokuu; vasontaaika
suehpedsdajve	vasomisseutu
suehpedslaante	vasomisalue
suejies	tuulensuojainen
suejnie	(kenkä)heinä
suejnietjuahpa	paikka, josta niitetään kenkäheinää
suelie	veren hera
suvvedh	kasvaa umpeen
svaale	naali
svaalnoe	viileä sää (auringonlaskun jälkeen)
svaaloe	viileä sää
sveehkestidh	kääntyä, poiketa syrjään, väistää; ohittaa
svïhtjedh	liikkua
svihtjedh	liikkua
svijrietjööse	poro, jolla on valkosia pilkkuja peräpäässä
svæjmadidh	pyörtyä
Svöörje	Ruotsi
sygkele	polkupyörä
syjhtedh	vahtia, hoitaa
syjhtere	(sairaan)hoitaja
sysngelasjh	(syötävät) sisälmykset
sægkodh	vetää (ylös, esim. kaloja; erilleen, esim. poroja teurastettavaksi)
sæjjoesdålle	avotuli
sæjlodh	väsyä, uupua
sæjloedidh	väsyttää
sæjloes	väsynyt
sæjrobpe	siirappi	
sæjra	siirappi	
sæjroe	kylki, sivu
sööjmes	hidas
sööjmeslaakan	hiljakseen
sööpedh	lakaista
såafoe	purolaakso
såajnodh	heinittää (kenkä)
såaketje	pieni koivu
såajmanidh	hidastaa vauhtia, kulkea hitaammin
såapoe	saippua
såara	(tuli)tikku
såarhta	musta poro
såarhte	laji
såårhte	laji
såekie	koivu
såemies	muutama, joku(nen)
såevmie	hieno kuiva laidun lumen alla
sån	han, hän; kai
såtnoeh	he kaksi (itse)
sååjhtedh	sattua (tekemään), tapahtua sattumalta
sååkesjidh	sahata
sååle	saari
såålhtedh	suolata
såålhtehke	suolattu, suolainen
såångedidh	kosia
såångedimmie	kosinta, kosio
såångedæjja	kosija
såårnedh	kertoa, ilmoittaa
sååvrehke	irtonainen ja karkea (lumi keväällä)
taavla	taulu
tabledth	tabletit
taxisijjie	taksikeskus
teatere	teatteri
teknigkere	teknikko
telefovnhnommere	puhelinnumero
tïjje	aika
tjaakanidh	mahtua
tjaaleldh	kirjallisesti
tjaangedh	astua, mennä sisään; pistää esiin
tjaangelidh	pujahtaa
tjaangestidh	pistäytyä
tjaatsetje	vähän vettä
tjaebpie	kaunis
tjaebpies	kaunis
tjaebpieslaakan	kauniisti
tjaeledh	kirjoittaa
tjaelemegærja	vihko
tjaetsie	vesi
tjagkeredeava	kuiva kovapohjainen kumpu
tjahkan	istuallaan, istumassa
tjahkasjidh	istua
tjahke	vuorenhuippu
tjahta	kilo(gramma)
tjaktje	syksy
tjaktjedaelvie	syystalvi
tjaktjegiesie	syyskesä
tjaktjeniestie	syysteuras
tjaktjeniestieh	syysteuras
tjarke	kovin, ponnekkaasti
tjarve	kantohanki
tjaste	karkea lumi, josta voi sulattaa vettä; jäätelö
tjeallere	kellari
tjeapohke	kaula
tjeapohkelijnie	kaulaliina
tjeara	(ilta)hämärä
tjearmehke	1 1/3 – 2 1/3 vuotias naarasporo
tjearodh	itkeä
tjeavla	kalvoin (verkonkudonnassa), verkon merkkikoho
tjeavlagierkie	verkon kives, paino
tjeavlarietjmie	verkon (ylä)paula
tjeehpes	musta
tjeehpeslaaketje	mustahko, mustanlainen
tjeekehtidh 	vetää, mahduttaa
tjengkere	pallo
tjeengkere	pallo
tjelmehts	sokea
tjelmie	silmä
tjetskehke	utelias, kiinnostunut
tjetskie	kärppä
tjevties	tiukkalihainen, tuore (kala)
tjidtj’aahka	äidin äiti, mummo
tjidj’aajja	äidin isä, vaari
tjidtjie	äiti
tjiehtjele	huone
tjiehtjere	varvas; pikkusormi, pikkuvarvas
tjïekedidh	piiloutua
tjïekerdidh	etsiä ruokaa lumen alta (poro)
tjïektjedh	potkia
tjïektjesjuelkie	takajalka
tjïelkestimmie	selitys
tjïelte	kunta
tjïeltekontovre	kunnantoimisto
tjiermie	munuainen
tjïeskedh	halkaista, halkoa (ydinluita)
tjietjelen	yksinään, omissa oloissaan
tjietsie	setä (isän pikkuveli)
tjietsuve	isoveljen lapsi (tjietsielle)
tjihkedidh	istuutua
tjihkiejovje	kokonaan valkoinen poro
tjihtedidh	tunkeutua sisään
tjïjhke	kiikari
tjïjhkerde	kiikari
tjïjhkestidh	kiikaroida
tjïjhtje	seitsemän
tjïjhtjede	seitsemäs
tjirkedh	vakuuttaa; uskaltaa
tjïrre	(puu)hiili
tjïrrh	läpi, kautta
tjoehpedh	leikata; hakata (kirveellä)
tjoehpestidh	leikata, hakata irti
tjoeje	ääni
tjoejenesguhpie	äänenvaimennin
tjoejhke	sääski
tjoejkedh	hiihtää
tjoejkegåetedh	alkaa hiihtää
tjoejkelidh	lähteä pois hiihtäen
tjoejkije	hiihtäjä
tjoejkijidh	lähteä hiihtämään
tjoekedh	latkia, lipoa
tjoele	saippua
tjoelme	solmu
tjoeme	kalannahka
tjoemehtidh	pyytää, rukoilla, vaatia
tjoeredh	täytyä
tjoermedh	rukoilla
tjoermehtasse	rukous
tjoeveridh	täytyä
tjoevkese	valo
tjoevtenje	avain
tjogneh	tavarat, kamppeet
tjohkeldhsuejnie	kammattu kenkäheinä
tjohpe	myssy, päähine
tjonne	lampi
tjonnetje	pieni lampi
tjorme	viime vuoden vasa
tjovke	poikanen
tjovrese	niska
tjovve	kurkku, nielu, ruokatorvi
tjuahpa	hakkuuaukio
tjuavkeds	valoisa
tjuedtjielidh	nousta ylös
tjuerpies	kömpelö
tjuetie stoerretjuetie	satatuhatta
tjuvliestidh	suudella
tjuvtjiedidh	osoittaa (sormella)
tjuvviestidh	sataa sisään räppänäaukosta
tjyöresthtjelmieh	itkusilmät
tjöödtjhsijjie	maali
tjöödtjehtidh	seisahtua
tjöödtjestidh	seisahtaa
tjööjjeste	pahoinvointinen
tjööke	keittiö
tjöönghkedh	kerätä, koota
tjöönghkesovvedh	tulla kerätyksi
tjöönghkestalledh	keräillä
tjööse	vaaleanharmaa poro, jolla on vaalea läiskä päässä
tjöösenjuenie	valkoturpainen poro
tjåadtjodh	seistä; olla kirjoitettuna
tjåadtjoestidh	seistä vähän aikaa
tjåagkoe	haarukka
tjåalodh	suolistaa, perata
tjåanghkan	yhteen, kokoon
tjåanghkoe	kokous	
tjåarvodh	huutaa
tjåegkedh	kerätä, koota; napata, siepata
tjåejjie	vatsa
tjåejjiennuelie	vatsanalus
tjåelieh	suolet, sisälmykset, perkeet
tjåenghkies	koossa, koottu(na)
tjåentjeme	poron takajalan ylempi ydinluu
tjåenhtjeme	poron takajalan ylempi ydinluu
tjåenieh	matkatavarat
tjåervie	sarvi
tjåerviesaelhtie	hirvensarvisuola
tjåetskeme	pakkanen
tjåhkeme	kampa, häkilä (kenkäheinän käsittelyä varten)
tjåhkodh	kammata kenkäheinää
tjåktja	metso
tjååhpedidh	mustua
traktovre	traktori	
traaktovre	traktori	
treavka	suksi
treavkagaahtjeme	hiihtokilpailu(t)
treblienjuenie	harmaa poro, jolla on pieniä valkoisia pilkkuja turvassa
trïengke	renki
trimhkeldahkesne	sirrillään
truhkie	puuvati, kaukalo
træjpoe	huono (tuulinen, sateinen) sää
tråahpoe	porras, portaat
tråahpa	porras, portaat
tråajjoe	takki, neule, pusero
tråajja	takki, neule, pusero
tråamhpoeh	nykerö
tråjjadidh	viihtyä
tråjjes	viihtyisä
tröjjes	viihtyisä
tryjjes	viihtyisä
tsaapedh	leikata, silputa, pieniä
tsaapestahke	suikaleliha (kahvin kanssa syötävä)
tsaapestidh	leikata palasiksi
tsaekedh	pistää, työntää sisälle, vetää päälleen, ajaa poroja aitaan
tsaekiehtidh	työntää sisään
tsagkedh	levittää; estää, pidätellä; pistää, panna sisälle
tsavnoe	naisen sukuelin
tseagkoehgåetie	pystykota
tsebpie	poron etujalan alempi ydinluu
tseegkedh	rakentaa, pystyttää, panna pystyyn, panna tulelle
tsegkie	haarapäinen (kotakorvan) tukipuu; naulakon naula
tsïnne	naisen sukuelin (karkeampi sana kuin tsavnoe)
tsoedtse	kalvo
tsoevtse	tunturijäätikkö (kesällä)
tsumhtsie	roska, pöly
tsööpkedh	murtaa, taittaa
tsåahka	kello
tsåaptsele	paikallaan pysyvä
tsåhha	rakki, hurtta
tsååbpe	sammakko
tuhtjedh	arvella, olla mieltä
tuvriste	turisti
turriste	turisti
tyjje	kangas
tæjmoe	tunti
tåaleskaahpoe	ompelurasia
uktsie	yhdeksän
unnebe	pienempi
unnemes	pienin
unniedidh	pienentää
urriesmiesie	hirvasvasa
ussjedidh	ajatella, aikoa
utnedh	omistaa, käyttää
uvte	eteen
vaadtsajidh	lähteä kävelemään, lähteä pois
vaadtsehtjidh	kävellä, jaloitella, kuljeskella
vaajeshgærja	tarinakirja
vaajhkoen	ainoa, vähäinen
vaajmoe	sydän
vaajtelidh	toivoa
vaaksjodh	vartioida, tarkastaa, kokea
vaaksjoehtæjja	porovahti
vaalje	aukio, aukea paikka
vaalmestahke	selässä oleva (vaate)nyytti
vaane	tottunut
vaanhtse	lapanen
vaarjoeh	vaatteet
vaarjoevåarhkoe	vaatekaappi
vaaroe	kauppatavara
vaaroeh	kauppatavarat
vaaroehtidh	varoittaa, kehottaa
vaarredh	kulkea, juosta (ihminen)
vaarrestidh	juosta nopeasti, kipaista
vaasedh	ohittaa; kulua (aika)
vadtes	lahja
vadtese	lahja
vaedtsedh	kävellä, kulkea; käydä (koulua)
vaegkie	laakso
vaejvie	vaiva, huoli, kipu
vaejsjie	peto, susi, metsäneläin
vaejlie	kuume
vaeknie	ammukset
vaeknieh	ammukset
vaeltedh	ottaa
vaeltjehke	kokenut poromies
vaenemes	vähintään
vaenie	vähän
vaenies	vähän
vaerhpiedidh	apajoida, heittää nuottaa
vaerie	tunturi, vuori(sto)
vaesedh	ohittaa; kulua (aika)
vaestiedidh	vastata
vahka	viikko
våhkoe	viikko
valkesidh	lähteä (vähitellen) liikkeelle (poroelo)
van	han, hän
varki	pian, nopeasti; heti; varhain
varke	pian, nopeasti; heti; varhain
varres	tuore
veadta	puun juuri
veahketje	vähän apua
veaksahkåbpoe	vahvempi
veaksehke	vahva
vealasjidh	maata, olla makuulla, nojata
vealasjimmie	makailu
vealma	syvä suvantopaikka
vearadidh	olla, käydä (kylässä, vieraisilla)
vearelde	sää, ilma; maailma
veaskoe	laukku
veasodh	elää, asua
veasome	elämä, asuminen
vedtedh	antaa
veelestidh	paneutua makuulle (nopeasti)
veeljedh	valita
veelkes	valkoinen
veelle	piha, aukio
veerremes	pahin
veetejaavvoeh	vehnäjauhot
velkiehtidh	lähteä liikkeelle (poroelo)
vervesne	terve, hyväkuntoinen
vestie	paha, huono, ruma
vesties	paha, huono, ruma
viedtedh	sitoa kiinni; panna liekaan
vïedtje	seinä
vïedtjedh	noutaa, hakea
veedtjedh	noutaa, hakea
viehkie	apu, apulainen
viehkiedööpmedæjja	aputuomari, lautamies
viehkiehtidh	auttaa
viehkiehtæjja	apulainen, työntekijä
vielie	vielä, enää, enemmän
vïelle	veli
vïenhtedh	arvella, ajatella, uskoa	
vïere	kenkäheinäkerä, viera
vïeredh	veistää kirveellä
vierhkiedidh	kovertaa
vierhkiesijjie	verstas
viermie	verkko
vïernge	joenrinteen yläreuna; merenpohjarinne
vearnga	joenrinteen yläreuna; merenpohjarinne
vïerngebielie	merenpohjarinteen puoli
vïerngeraedtie	merenpohjarinteen reuna
viertedh	kaataa (puita)
vietjere	vasara
vietseles	ystävällinen
vievtjedidh	kääntyillä, pyöriskellä (kyljeltä toiselle)
vievtjije	sätkyttelevä
vigkie	riita
vihkeles	tärkeä
vihth	taas
vihth masten	vaihteen vuoksi
vihtie	tietty, tunnettu, varma
vihties	tietty, tunnettu, varma
vïjhte	viisi
vïjhtede	viides
vijhtsierdidh	visertää
vïjjedh	leikata kangasta
vïjlelidh	vilkaista
vijne	viini; viina
vijredh	metsästää
vïjredh	metsästää
vïlledidh	kurkottaa
vïnhtse	vene
viskes	keltainen
vissjedh	viitsiä, jaksaa
vissjehtovvedh	kyllästyä
vissjeles	ahkera, viitseliäs
vitnedh	voittaa, saavuttaa, ehtiä
voedtege	(kengän)nauha	
voeje	voi
voejedidh	uiskennella
voejelidh	lähteä uimaan
voejeskaahpoe	voirasia
voejhkelidh	yrittää (tehdä); käydä kiinni
voejkene	henki
voejngese	hengitys
voeksedidh	oksentaa
voektenje	vave, verkonkuivatusteline
voeledh	vuolla
voelpetje	(pikku)ystävä
voene	kylä, kiinteä asutus
voepte	hius
voeres	vanha; vanhus
voerese	vanha; vanhus
voeresgåetie	vanhainkoti
voerpehke	aamunvirkku
voesse	säkki, laukku, reppu
voessetje	pieni pussi, pieni säkki
voessjedh	keittää
voessjehtjidh	keitellä	
voessjemelihtie	keittoastia
voestegh	ensin
voestes	ensimmäinen
vuajajidh	lähteä ajamaan
vualadahke	alanko
vuartasjidh	katsoa
vuasta	juusto
vuebnie	uuni
vuejedh	ajaa
vuejeme	poikkipuu (kotakorvia yhdistävä orsi)
vuejemeleahpa	ajokortti
vuejije	ajaja, (auton)kuljettaja 
vuejnedh	nähdä
vuekie	tapa
vuelelen	alla, alapuolella
vuelkedh	lähteä
vuelnie	alhaalla, alla
vuemie	suuri metsää kasvava laakso, vuoma
vuenjele	2 1/3 – 3 1/3 vuotias naarasporo
voenjele	2 1/3 – 3 1/3 vuotias naarasporo
vueperes	2 1/3 – 3 1/3 vuotias urosporo
vuertedh	odottaa	
vueptiestidh	huomata, havaita
vuertiestidh	odottaa vähän
vuesiehtidh	osoittaa, näyttää
vuesiehtimmie	esitys, näyttely
vuetjedh	ampua
vyskedidh	kellastua
vyskehke	keltainen
vytnesjidh	askarrella, tehdä käsityötä
vytnesjimmie	käsityö, askartelu
vyöhkesidh	auttaa toisiaan
væjjoe	(leikkuu)kaava, malli
væjkele	taitava, kelpo
væjkeles	taitava, kelpo
værtoe	myrsky
vætnoe	(käsi)työ, askartelu
vöölemes	alin
vöölle	kovin, valtavan
vöörhkelidh	piilottaa (nopeasti)
vööste	vastaan
våarhkoe	säilytyspaikka, kätkö; kaappi
våaroes	varovainen, arka, valpas
våhkoe	viikko
vååjnedh	näkyä
vååjnoes	nähtävä(sti)
våålese	alas
vååltestahke	mäki jolta on hyvä näkyvyys
våårenjasse	susi, peto
övtebe	edellinen, viime
ööhpehtimmie	opetus, koulutus
ööjeldihks	unohtavainen, hajamielinen
öörnedh	järjestää; varoittaa; valmistaa
öövre	aivan, kokonaan
åabpa	sisar
åadtjestidh	heittää, ottaa kiinni suopungilla
åadtjodh	saada
åahpenadtedh	tutustua (useisiin)
åahpenidh	tutustua
åahpetje	tuttava
åajaldehtedh	unohtaa
åajsodh	jaksaa, kyetä
åajvoe	oiva(llinen)
åajvoeh	oiva(llinen)
åaksesjidh	karsia oksat
åaksetje	pikku oksa
åanehksguapa	nilkkasukka, lyhyt sukka
åarajidh	mennä nukkumaan
åarjelsaemie	eteläsaame(lainen)
åarjelvearelde	etelätuuli
åavroe	helle, kuuma sää
åavroes	kuuma, helteinen
åebrelen	syrjään; ylitse, enemmän kuin tarpeen
åehpies	tuttu
åejjie	pää
åejjieh saejriedieh	päätä särkee
åejjienalhke	tyyny
åajjienååleh	tyyny
åejvie	päällikkö, johtaja
åeksie	oksa
åelkie	olka(pää)
åelkies	oikea(npuoleinen)
åelkiesbielie	oikea puoli
åenehks	lyhyt
åeredh	nukkua	
åeremetjiehtjele	makuuhuone
åeremevaarjoeh	vuodevaatteet
åeremevoesse	makuupussi
åerie	verisuoni
åerpenh	sisarukset
åerpienadtjh	sisarukset
åesiestidh	käydä kauppaa; tehdä ostoksia
åesiestæjja	kauppias
åesie	osa, osuus (ruoasta); teurasporo
åesiesmaennie	kauppias
åesiesålma	kauppias
åestedh	ostaa
åhtjetje	vähäsen
åktsede	yhdeksäs
ålkene	ulkona
ålkone	ulkona
ålkoelisnie	ulkopuolella
ålloe	villa
ålloeabpese	villapaita, villapusero
ålloetråajja	villapaita, pusero
ålma	mies
ålmavoelpetje	miesystävä
ålvas	kamala, kauhea; kovin
ålvoes	kamala, kauhea; kovin
alvas	kamala, kauhea; kovin
ånnetji	vähäsen
ånnetje	vähäsen
årra	hirvas
årrodh	olla; asua
årroeminie	asumassa
åvtebarkoe	esityö, valmistautuminen
åvtegietjie	etupää
åvtehke	johtaja, esimies
åvtelen	eteen; ennen; vaille
åvtemennie	poron sarven etuhaara
åvtesjuelkie	etujalka
åvteste	edestä
åvteåejvie	johtaja
åvtelisnie	edellä; kauempana edessä
åvtine	edeltä, ensinnä
åålijes	mehukas, maukas (lihasta)
ååredæjja	kasvot
åårkeniste	urkuri
